[Lang]
ID=14
Caption=български език
Help=GaleUS.chm
ProportionalFont=MS Sans Serif
FixedFont=Courier New
FontSize=14
MainMenuFont=
MainMenuFontSize=

[Common]
Ok=OK
Cancel=Отказ
Abort=Abort
FileName=File Name
Compressed=Compressed
Compression=Compression
AlphaCh=Alpha Channel
WithAlphaCh=With Alpha Channel
Add=Add
Edit=Edit
Delete=Delete
Default=Default
Clear=Clear
Width=Width
Height=Height
List=List
Antialias=Antialias
KeepAspect=Keep Aspect Ratio
Top=Top
Bottom=Bottom
Left=Left
Right=Right
Close=Close
Option=Option
Folder=Folder
File=File
Drive=Drive
FileType=File Type
Size=Size
Color=Color
Optimize=Optimize
Quality=Quality
Progressive=Progressive
ColorDepth=Color Depth
Dither=Dither
Grayscale=Greyscale
TransparentColor=Transparent Color
Value=Value
Interlaced=Interlaced
Palette=Palette
PaletteFile=Palette File
Comment=Comment
Preset=Preset
Separator=Separator
Save=Save
SaveAs=Save As
Reset=Reset
MoveUp=Move Up
MoveDown=Move Down
Sort=Sort
Path=Path
Color=Color
Name=Name
Hex=Hex
Delay=Delay
Disposal=Disposal
FrameNumber=Frame Number
FrameName=Frame Name
Tolerance=Tolerance
Fill=Fill
Opacity=Opacity
PreserveTransparency=Preserve Transparency
Font=Font
Update=Update
Properties=Properties
AllFrames=All Frames
Transparency=Transparency
NoChange=No Change
Back=Back
Next=Next
Icon=Icon
Cursor=Cursor
Preview=Preview
Frame=Frame
Frames=Frames
All=All
Undo=Undo
Redo=Redo
MatchPixels=Match Pixels with Colors
ColorTable=Color Table
Bitmap=Bitmap
AnimatedCursor=Animated Cursor
New=New
Open=Open
View=View
Image=Image
Capture=Capture
Window=Window
Tool=Tool
Layer=Layer
MainMenu=Main Menu
PopupMenu=Popup Menu
Function=Function
Caption=Caption
bpp=bpp
BackgroundColor=Background Color
Length=Length
Loop=Loop
Code=Code
NumberOfFrames=Number of Frames
FileSize=File Size
Negative=Negative
Copy=Copy
Paste=Paste
Move=Move
MultipleLayers=Multiple Layers
Crop=Crop
FitImage=Fit to Image
ColorPalette=Color Palette
Load=Load
Swap=Swap
Input=Input
Help=Help
ActualSize=Actual Size
ActualSpeed=Actual Speed
Slower=Slower
Slowest=Slowest
Faster=Faster
Fastest=Fastest
Main=Main
None=None
Toolbar=Toolbar
Setup=Setup
TrashBox=Trash Box
Both=Both
Dockable=Dockable
Lock=Lock
CursorCoordinates=Cursor Coordinates
AutoHide=Auto-Hide
KeepAwayFromCursor=Keep Away From Cursor
StartEdit=Start Edit
Key=Key
System=System
LoopFirstLast=Loop the first and the last
Confirmation=Confirmation
CurrentFrame=Current frame
SelectedFrames=Selected frames
AlignmentLeft=Left
AlignmentCenter=Center
AlignmentRight=Right
AlignmentTop=Top
AlignmentMiddle=Middle
AlignmentBottom=Bottom
Tile=Tile
Draggable=Draggable
DateModified=Date Modified
Search=Search
Row=Row
Column=Column
CurrentImage=Current Image
Clipboard=Clipboard
MiddleMouseButton=Middle Mouse Button
MouseWheelUp=Mouse Wheel Up
MouseWheelDown=Mouse Wheel Down

[Compression]
Default=Default Compression
No=No Compression
Nonreversible=Nonreversible Compression

[Magnification]
Caption=Magnification
InitList=Would you like to initialize list?
Magnification=Magnification(%):

[UniteColor]
Prompt=Duplicate colors will be filled with the following color

[UnusedColor]
Prompt=Unused colors will be filled with the following color

[UniformColor]
Prompt=Uniform the colors in images with 1,4,8 bpp format. Select images.
BtnExtract=&Extract
BtnApply=&Apply
BtnReselect=&Reselect
TotalIsOver=The Total number of colors used in all images is over the maximum number of colors[%d]
MaxNumber=Maximum number of uniform colors is %d

[CustomGrid]
Caption=Custom-Grid
AddAdvancedGrid=Add Ad&vanced Grid...
Add=&Add...
Edit=&Edit...
Delete=&Delete...
GridSize=Grid Size
DividedNum=Divided Number
Visible=Visible
Size=Size:
Number=Number:

[AdvancedGrid]
Caption=Advanced Custom-Grid
MainGrid=Main Grid
SubGrid=Sub-Grid
Add=&Add
Replace=&Replace
Delete=&Delete
MainX=&X:
MainY=&Y:
MainSpecifyColor=Specify &Color
MainVisible=&Visible
SubX=X(&1):
SubY=Y(&2):
SubSpecifyColor=Specify C&olor
SpecifyName=Specify &Name
StartPositionX=&Start Position X
StartPositionY=S&tart Position Y
SubStartPositionX=&Start &Position X
SubStartPositionY=S&tart P&osition Y

[Slope]
Step=&Step:

[Hotkey]
Hotkey=HotKey

[Rotate]
Angle=&Angle
Position=Position
Center=&Center

[Resample]
Smooth=&Smooth
ByPixel=by &Pixel
ByPercent=by P&ercent
CurSize=Current Size: 

[RemoveBorder]
ImageSize=Image Size: 

[Register]
Caption=Register
SWInfo=This software is a shareware.\nTrial period is 30 days.\nVisit our web site to purchase GraphicsGale.\n\nhttp://www.humanbalance.net/gale/us/
Name=Name:
Mail=E-Mail:
Pass=Password:
Succeeded=Thank you for registering GraphicsGale!
Failed=The name, the e-mail address, or the password is wrong.
Purchase=Purchase
Trial=This software is a shareware.\n\nTrial period will expire in %d days
Expired=Trial period has expired.\n\nIf you wish to continue to use GraphicsGale, please purchase the software.

[About]
Caption=За програмата GraphicsGale
Trial=Trial
License=Този продукт е лицензиран за използване от:

[SetAlphaCh]
Caption=Set Alpha Channel
CreateFrom=&Create From:
Source=&Source
CurrentLayerOnly=Current Layer Only
Invert=&Invert
CurrentSelection=Current Selection
OpaqueColors=Opaque Colors
Luminance=Luminance

[AVI]
StartFrame=&Начален кадър:
EndFrame=&Краен кадър:
FrameRate=&Брой кадри в секунда (Frame Rate):

[Batch]
UnableOpen=Unable to open "%s"
UnableSave=Unable to save "%s"
Overwrite=%s\nalready exists.\nWould you like to overwrite it?
Input=Input
Output=Output
WhenOverwrite=&When Overwriting:
Convert=C&onvert
OverwriteConfirm=Confirm
OverwriteSkip=Skip To The Next
OverwriteAny=Overwrite Any Files
ResampleOriginal=Maintain Original
ResampleSize=Specify Size
ResampleSizeAspect=Specify Size (Keep Aspect Ratio)
ResamplePercent=Specify Percent
ColorDepthOriginal=Maintain Original
TransparentOriginal=Maintain Original
TransparentNone=No Transparent Color
TransparentValue=Specify Value
TransparentTopLeft=Pick Up Top-Left Pixel
TransparentTopRight=Pick Up Top-Right Pixel
TransparentBottomLeft=Pick Up Bottom-Left Pixel
TransparentBottomRight=Pick Up Bottom-Right Pixel
BrowseFolder=&Browse Folder...
SameAsOutput=Same as O&utput
SameAsInput=Same as &Input

[AdjustColor]
Brightness=&Brightness
Contrast=&Contrast
GammaCorrection=&Gamma Correction
Saturation=S&aturation

[CombineLayers]
DeleteOriginal=&Delete Original Layers
MakeAlphaCh=&Make Alpha Channel

[ColorDepth]
PixelFormat=&Pixel Format
Format1=1bpp (2 Colors)
Format4=4bpp (16 Colors)
Format8=8bpp (256 Colors)
Format15=15bpp (High Color)
Format16=16bpp (High Color)
Format24=24bpp (Full Color)
Colors=&Colors:
Algorithm=&Algorithm
Type=Type

[Cursor]
HotSpotX=Hot Spot &X:
HotSpotY=Hot Spot &Y:

[Bookmarks]
Caption=Отметки

[Effects]
Amount=&Amount:
Synchronize=&Synchronize
Noise=Noise
Mosaic=Mosaic
Light=Light
Buttonize=Buttonize
BorderWidth=&Border Width:
Depth=&Depth:
Pressed=&Pressed
Original=(Original)
Blur=Blur
BlurMore=Blur More
Sharpen=Sharpen
SharpenMore=Sharpen More
Noise=Noise
Mosaic=Mosaic
FindEdges=Find Edges
FindEdges2=Find Edges2
Emboss=Emboss
EmbossMore=Emboss More
Light=Light
Spotlight=Spotlight
Buttonize=Buttonize

[EnlargeCanvas]
SpecifySize=Please specify the size of new canvas.
ImagePosition=Image Position:

[Export]
Type=&Type:
Columns=&Columns:
Prefix=&Prefix:
OutputBmp=O&utput as BMP
FrameProperties=Frame Properties:
OutputCSV=&Output as CSV
MultipleFiles=Multiple Files
CombinedImage=Combined Image
Padding=&Padding:
Trim=Trim
TrimTransparentPixels=T&rim Transparent Pixels

[Fill]
Contents=Contents
Use=&Use:
CurrentColor=Current Color
PatternFile=Pattern(File)
PatternClipboard=Pattern(Clipboard)
Clear=Clear
Blending=Blending
Arrangement=&Arrangement:
Tile=Tile
Brick=Brick
Random=Random
ColumnSpacing=&Column Spacing:
RowSpacing=&Row Spacing:
OffsetX=Offset &X:
OffsetY=Offset &Y:
Amount=A&mount:
AllowDrawingPartOfAnImage=A&llow drawing part of an image
Regenerate=&Regenerate
Preview=Pr&eview
Gradient=Gradient
Color1=&Color1:
Color2=Co&lor2:
Opacity1=Opacity&1:
Opacity2=Opacity&2:
Type=Type:
9slicing=9-slicing
Borders=Borders:
Edit=Edit &Borders...
DrawMode=&Draw Mode:
Stretch=Stretch
Tiled=Tiled

[DrawText]
Styles=Styles:
Bold=&Bold
Italic=&Italic
Underline=U&nderline
Strikeout=St&rikeout
Border=B&order:
Pitch=Pit&ch:
MixBase=&Mixed with Base Image
Text=T&ext
LineSpace=Line Space(&J):
Alignment=Ali&gnment:
History=&History:

[FontPreset]
IncludeText=Include &Text
IncludeColor=Include &Color

[FrameProperties]
Delay60=1/60 sec. (for Video-Game)
Delay100=1/100 sec. (for GIF)
Delay1000=1/1000 sec.
DelayMultiply=Multiply
DelayAdd=Add
DisposeNot=Not Specify
DisposeNo=Not Dispose
DisposeBG=Fill with Background Color
DisposePrev=Restore to Previous

[ImportCombined]
DividedNum=Divided Number
PieceSize=Piece Size
SourceSize=Source Size:
Source=Source
File=&Файл...
Clipboard=&Clipboard

[ImportMultiple]
ImportFiles=Import &Files:
HorizontalAlignment=&Horizontal Alignment
VerticalAlignment=&Vertical Alignment

[LoadPalette]
Caption=Load Palette
DragSelect=Drag to select
ClickPaste=Click to paste
ImportFile=Import From &File...
ImportClipboard=Import From &Clipboard

[Palette]
CantSaveFormat=Can not save palette in this format.
CantLoadFormat=Can not load palette in this format.
EmptyData=Palette data is empty.
MenuMakeGradation=Make Gradation

[PasteRGB]
WhatWay=What way
PasteFirst=Paste to &first color
PasteSecond=Paste to &second color
PasteMulti=Paste &multiple colors to range beginning with the first color
ColorsInClip=%d colors in clipboard

[Print]
Measure=&Measure
FitPage=F&it to Page
PutCenter=&Put to Center
Copies=C&opies:
To=to
Layout=L&ayout
NumberOfPages=Number of Pages:

[Properties]
SinglePalette=&Single Palette
DisableTransparency=&Disable Transparency of Bottom Layer
Second=sec.
MergeAllColorsInUse=Merge all colors in use
MatchPixelWidthColor=Apply current colors (Match pixel with color)
KeepPixelIndex=Apply current colors (Keep pixel's index)
ColorsInUseAreTooManyToMerge=Colors in use are too many to merge

[Preferences]
SpaceKey=Space-key
AltKey=Alt-key
Assigned=Assigned
DuplicateKeys=Duplicate Keys
UseHalftone=Use Halftone When Reduced(Slow)
FitWhenMagnifying=Fit Window When Magnifying
AutoZoomOpening=Auto Zoom in Opening File
Min=Min.
Max=Max.
MinMagnificationGrid=Minimum Magnification to Display Grid
GridColor=Grid Color
CustomGridColor=Custom-Grid Color
TaskPriority=Task Priority
High=High
AutoStart=Auto Start
ZoomMouseCursor=Zoom The Area Around The Mouse Cursor
DisplayPenpoint=Display A Penpoint
ToolbarWidthHidden=Toolbar Width in Hidden State
ToolbarHideDelay=Delay Time to Hide Toolbar
DisableTransparency=Disable Transparency of Bottom Layer (Default Value of Properties)
NotDialogAddLayer=Does Not Show The Dialog Box in Adding Layer
NotAskDeleteLayer=Does Not Ask in Deleting Layer
NotAskCombineLayer=Does Not Ask in Combining Layers
DeleteAlphaChCapture=Delete Alpha Channel in Capturing Screen Image
SetTransparentPaste=Set Transparent Color Automatically in Pasting Layer
DefaultCanvasColor=Default Canvas Color
Colors4bpp=4bpp (16 colors)
Colors8bpp=8bpp (256 colors)
Colors15or16or24bpp=15,16,24bpp
ApplySettingPasteNew=Apply The Above Setting in Pasting New Image
NotDialogAddFrame=Does Not Show The Dialog Box in Adding Frame
NotAskDeleteFrame=Does Not Ask in Deleting Frame
DefaultBGColor=Default BG Color
FillSelectionSecondColor=Fill selection with second color
NotEraseSelection=Does Not Erase Image Under Selection
PickColorCurrentLayer=Source of Color Picker is Current Layer (Switched by Shift-key)
DefaultColorPalette=Default Color Palette
ShowColorBalloon=Show Balloon Tip with Color Value
PaletteSize=Palette Interface Size
SyncRGBBar=Synchronize Color of RGB Bar with Current Value
ShowGrid=Show Grid
UsageICOTransparency=Usage of ICO Transparency
TransparentColorFrame=Transparent Color of Frame
AlphaChLayer=Alpha Channel of Layer
ReplacementColor=Replacement Color
SupportSusiePlugin=Support Susie Plug-in (Restart Required)
SetAlphaChHiFulleColor=Set Alpha Channel to 15,16,24 bpp Image
ClearRecentFilenames=Clear Recent Filenames
JPGQuality=JPG Quality
OptimizeGIF=Optimize GIF
Language=Language
RestartRequired=*Restart Required
AllowMultipleInstances=Allow Multiple Instances
MaximumUndoLevels=Maximum Undo Levels
AddParent=Add Parent
AddSeparator=Add Separator
DefaultDelay=Default Delay
SelectionWithRightDrag=Selection with Right-Drag
PickColorByAltClick=Pick Color by Alt-Click
UseWacomTablet=Use Wacom Tablet
DefaultName=Default Name
AutomaticallyCheckForUpdate=Automatically check for update
ResetToolbarPositions=Reset Toolbar Positions
EditInvisibleLayer=Edit Invisible Layer
EditInvisibleLayerDisable=Disable
EditInvisibleLayerEnable=Enable
EditInvisibleLayerConfirm=Confirm

[FileDialog]
BookmarkEdit=Edit list
BookmarkAdd=Add current folder into the list
IconSaveNew=Save newly
IconSaveUpdate=Update
IconSaveCustomize=Customize
Overwrite=Overwrite:
Modified=Modified:

[Message]
LoupeKeepAway=Loupe window will keep away from mouse cursor.\nTo catch the window, hold Control-key down and bring cursor.
PreviewKeepAway=Preview window will keep away from mouse cursor.\nTo catch the window, hold Control-key down and bring cursor.
UsedColorNumbers=The number of unique colors in the current layer is %d.\nThe number of unique colors in the current frame is %d.\nThe number of unique colors in the file is %d.
MakeGradation=Color gradation will be made between the first color and the second color.
InitColorPalette=Color palette will be initialized with default values.
CantSeparateAnime=Can not separate the current image
ClipImageNotFit=The image of a clipboard does not fit to a current image.
SelectOutputFolder=Please select output folder
Change8bpp=Would you like to change the image to 8bpp(256colors) format?
DeleteSelectedFrame=Selected frame(s) will be deleted.
DeleteLayer=Current layer will be deleted.
AffectSelectedFrames=This function will affect all selected frames.
DontShowThisDialogAgain=Don't show this dialog again
PreferencesDeleteHistory=Would you like to remove all recent filenames from file menu?
SaveAll=All images are going to be saved into a disk.
SaveGifSubBpp=GIF format does not support high-color and full-color.\nShould the image be changed to 8bpp(256colors) format?
ConfirmClose=This file has been changed. Would you like to save the changes?'
FailedCcreateAVI=Failed to create an AVI file.
FileBroken=This file is broken.
DeleteSelected=Would you like to delete selected item?
ClearItems=Would you like to erase all items?
SpecifySome=Please specify "%s".
LayerLocked=Layer is locked.
LayerInvisible=Layer is invisible.
TryLatestVer=Can not load this file. Try the latest version.
NewVersionIsAvailable=New version is available. Do you want to visit homepage?
DownloadFailed=Download failed.
YourVersionIsUpToDate=Your version is up to date.
WouldYouLikeToResetTheToolbarPositions=Would you like to reset the toolbar Positions?
BackupFolderDifferentFromGraphicsGale=Be aware that the backup folder is set to a different drive from the GraphicsGale installation drive.
AutoSaveFolderDifferentFromGraphicsGale=Be aware that the auto save folder is set to a different drive from the GraphicsGale installation drive.
ChooseEditingInvisibleLayer=Do you want to include invisible layer in the processing target?
ConfirmEditingInvisibleLayer=Are you sure you want to edit an invisible layer?

[ActionCategory]
AllFrames=Всички кадри
Capture=Заснемане на видео
Edit=Редактиране
File=Файл
Frame=Кадър
Help=Помощ
Image=Изображение
Layer=Слой
PaintMode=Режим за рисуване
Palette=Палитра с цветове
Tool=Инструмент
View=Изглед
Window=Прозорец
Preview=Предварителен изглед

[ActionName]
AllFramesAdjustColor=Adjust Color
AllFramesColorDepth=Color Depth
AllFramesCrop=Crop
AllFramesRemoveBorder=Remove Border
AllFramesEnlargeCanvas=Enlarge Canvas
AllFramesFitToImage=Fit to Image
AllFramesFlipHorizontal=Flip Horizontal
AllFramesFlipVertical=Flip Vertical
AllFramesGrayscale=Grayscale
AllFramesNegative=Negative
AllFramesResample=Resample
AllFramesRotate=Rotate
AllFramesScroll=Scroll
AllFramesSlope=Slope
CaptureFullScreen=Full Screen
CaptureHotKeySetup=HotKey Setup
CaptureWindow=Window
EditCopyDisplayImage=Copy Display Image
EditCopy32bpp=Copy[32bpp]
EditCopy=Copy
EditCut=Cut
EditDelete=Delete
EditDuplicateImages=Duplicate Image(s)
EditFill=Fill
EditGroupedRedo=Grouped Redo
EditGroupedUndo=Grouped Undo
EditImport=Import
EditInvertSelection=Invert Selection
EditMoveSelectionDown=Move Down
EditMoveSelectionLeft=Move Left
EditMoveSelectionRight=Move Right
EditMoveSelectionUp=Move Up
EditPaste=Paste
EditPasteLayer=Paste Layer
EditPasteMove=Paste/Move
EditPasteNewImage=Paste New Image
EditPickColorFromCurrentLayer=Pick Color From Current Layer
EditPickColor=Pick Color
EditPickSecondColorFromCurrentLayer=Pick Second Color From Current Layer
EditPickSecondColor=Pick Second Color
EditRedo=Redo
EditSelectAllLayers=Select All Layers
EditSelectAll=Select All
EditUndo=Undo
EditModifySelection=Modify Selection
EditExpandSelection=Expand Selection
EditContractSelection=Contract Selection
EditStroke=Stroke
EditDeselect=Deselect
EditMoveSelection=Move Selection
EditMoveSelectionLeftEdge=Move to Left Edge
EditMoveSelectionHorizontalCenter=Move to Horizontal Center
EditMoveSelectionRightEdge=Move to Right Edge
EditMoveSelectionTopEdge=Move to Top Edge
EditMoveSelectionVerticalCenter=Move to Vertical Center
EditMoveSelectionBottomEdge=Move to Bottom Edge
FileAcquire=Acquire
FileBatchConversion=Batch Conversion
FileBrowse=Browse
FileClose=Затваряне
FileExit=Изход
FileExport=Експорт (Изнасяне като...)
FileImportFromCombinedImage=Import From Combined Image
FileImportFromMultiFiles=Import From Multi Files
FileNew=New
FileOpen=Open
FilePreferences=Preferences
FilePrint=Print
FilePrinterSetup=Printer Setup
FileProperties=Свойства
FileSaveACopy=Запис на копие
FileSaveAll=Запис на всичко
FileSaveAs=Запис като...
FileSave=Запис
FileSelectSource=Select Source
FrameAdd=Добавяне
FrameInsertIntoLeft=Insert into Left
FrameInsertIntoRight=Insert into Right
FrameBackFrame=Back Frame
FrameCopy=Копиране
FrameCut=Изрязване
FrameDelete=Изтриване
FrameDuplicate=Дублиране
FrameDuplicateIntoLeft=Duplicate into Left
FrameDuplicateIntoRight=Duplicate into Right
FrameForwardFrame=Forward Frame
FrameMerge=Сливане
FrameMove=Move Frame
FramePaste=Paste Frames
FramePasteToLeft=Paste to Left
FramePasteToRight=Paste to Right
FramePause=Пауза
FramePlay=Изпълнение
FrameProperties=Свойства
FrameReverse=Reverse
FramePlayFromFirstFrame=Play From First Frame
FramePlayFromCurrentFrame=Play From Current Frame
HelpAbout=За програмата
HelpContents=Съдържание
HelpCheckForUpdate=Проверка за обновление
ImageAddAlphaChannel=Add Alpha Channel
ImageAdjustColor=Настройка на цвета
ImageCountColorsUsed=Преброяване на използваните цветове
ImageDeleteAlphaChannel=Delete Alpha Channel
ImageDuplicateAlphaChannel=Duplicate Alpha Channel
ImageEffect=Ефект
ImageFlipHorizontal=Flip Horizontal
ImageFlipVertical=Flip Vertical
ImageGrayscale=Grayscale
ImageInvertAlphaChannel=Invert Alpha Channel
ImageMakeAlphaChannel=Make Alpha Channel
ImageNegative=Ефект негатив
ImageRotateBy90Degrees=Rotate by 90 Degrees
ImageRotate=Rotate
ImageScrollDown=Scroll Down
ImageScrollLeft=Scroll Left
ImageScrollRight=Scroll Right
ImageScrollUp=Scroll Up
ImageScroll=Scroll
ImageSlope=Slope
LayerAdd=Добавяне
LayerAlpha=Switch Alpha Channel
LayerCombine=Combine Visible
LayerCombineDown=Combine Down
LayerCopy=Копиране на слой
LayerDelete=Изтриване
LayerDuplicate=Дублиране
LayerLock=Заключване на слой
LayerLockCurrentFrame=Lock Layers in Current Frame
LayerLockAllLayers=Lock Layers in All Frames
LayerLockAllAllLayers=Lock All: All Layers
LayerLockAllCurrentFrameLayers=Lock All: Current Frame Layers
LayerLockTransparentAllLayers=Lock Transparent: All Layers
LayerLockTransparentCurrentFrameLayers=Lock Transparent: Current Frame Layers
LayerNotLockAllLayers=Unlock: All Layers
LayerNotLockCurrentFrameLayers=Unlock: Current Frame Layers

LayerMove=Move Layer
LayerNextLayer=Next Layer
LayerPreviousLayer=Previous Layer
LayerPropertiesWithSameName=Properties with Same Name
LayerProperties=Properties
LayerReverseVisibilityWithSameName=Reverse Visibility with Same Name
LayerReverseVisibility=Reverse Visibility
LayerVisible=Change Visibility
LayerMoveUp=Move Up
LayerMoveDown=Move Down
PaintModeNext=Next Mode
PaintModePrevious=Previous Mode
PaintModeClear=Clear
PaintModeNormal=Normal
PaintModeOpacity=Opacity
PaletteCopy=Copy Colors
PaletteCopyRGBValue=Copy RGB Value
PaletteCopyRGBValues=Copy RGB Values
PaletteDefaultPalette=Default Palette
PaletteDeleteUnused=Remove Unused Colors
PaletteLoadPalette=Load Palette
PaletteMakeGradation=Make Gradation
PaletteMove=Move Color
PalettePasteRGBValue=Paste RGB Value
PaletteReloadPenTile=Reload Pen/Tile
PaletteOpenPenTileFolder=Open Pen/Tile Folder
PaletteRGB=Adjust RGB
PaletteSavePalette=Save Palette
PaletteSelectTransparentColorToFirstColor=Select Transparent Color As First Color
PaletteSelectTransparentColorToSecondColor=Select Transparent Color As Second Color
PaletteSwapColor=Swap Color
PaletteUniformColors=Uniform Colors
PaletteUniteDupli=Unite Duplicate Colors
PaletteSelectNext=Select Next Color
PaletteSelectPrevious=Select Previous Color
ToolAntialias=Antialias
ToolColorReplacer=Color Replacer
ToolColorSelection=Color Selection
ToolConnectLine=Connect Line
ToolFilledOval=Filled Oval
ToolFilledRectangle=Filled Rectangle
ToolFloodFill=Flood Fill
ToolLasso=Lasso
ToolMagicWand=MagicWand
ToolMover=Mover
ToolOvalSelection=Oval Selection
ToolOval=Oval
ToolPen=Pen
ToolRectangle=Rectangle
ToolRectangularSelection=Rectangular Selection
ToolSplineCurve=Spline Curve
ToolText=Draw Text
ToolTransparent=Transparent
ToolZoom=Zoom
ViewActualSize=Actual Size
ViewFrame=Frame
ViewGrid=Мрежа
ViewHistory=История
ViewLayer=Слой
ViewLoupe=Лупа
ViewOnionSkin=Onion Skin
ViewPalette=Палитра
ViewPreview=Предварителен изглед
ViewSelectedLine=Selected Line
ViewSnap=Snap
ViewToolbarFrame=Frame
ViewToolbarLayer=Layer
ViewToolbarMain=Main
ViewToolbarTool=Tool
ViewZoomInResizeWindow=Zoom in (Resize window)
ViewZoomIn=Zoom in
ViewZoomOutResizeWindow=Zoom out (Resize window)
ViewZoomOut=Zoom out
ViewCustomGrid=Show Custom-Grid
WindowArrangeIcons=Arrange Icons
WindowCascade=Cascade
WindowCloseAll=Затваряне на всички
WindowDuplicate=Дублиране
WindowFitToImage=Fit to Image
WindowSeparateAnimatedArea=Separate Animated Area
WindowTileHorizontal=Tile Horizontally
WindowTileVertical=Tile Vertically
PreviewZoom25=Намаляване до 25%
PreviewZoom50=Намаляване до 50%
PreviewZoom100=Връщане до 100%
PreviewZoom200=Увеличаване до 200%
PreviewZoom300=Увеличаване до 300%
PreviewZoom400=Увеличаване до 400%
PreviewZoom800=Увеличаване до 800%
PreviewSpeedSlowest=Playback Speed Slowest
PreviewSpeedSlower=Playback Speed Slower
PreviewSpeedActual=Playback Speed Actual
PreviewSpeedFaster=Playback Speed Faster
PreviewSpeedFastest=Playback Speed Fastest
PreviewSequenceForward=Forward Playback
PreviewSequenceReverse=Reverse Playback
PreviewSequenceForwardAndReverse=Forward and Reverse Playback
PreviewSequenceRepeatSection=Edit Repeat Section
PreviewSequenceDeleteRepeatSection=Delete Repeat Section
PreviewTile=Tile
PreviewFillBGColor=Fill with Background Color
ToolExecuteFloodFill=Execute Flood Fill Directly

[ActionHint]
AllFramesAdjustColor=Adjust Color.
AllFramesColorDepth=Change Pixel Format.
AllFramesCrop=Crop the image.
AllFramesRemoveBorder=Remove borders of the image.
AllFramesEnlargeCanvas=Enlarge Canvas.
AllFramesFitToImage=Delete Unnecessary Edges.
AllFramesFlipHorizontal=Flip the image horizontal.
AllFramesFlipVertical=Flip the image vertical.
AllFramesGrayscale=Change the image to grayscale.
AllFramesNegative=Change the image to negative.
AllFramesResample=Resize or resample the image.
AllFramesRotate=Rotate the image.
AllFramesScroll=Roll the image.
AllFramesSlope=Slope the image.
CaptureFullScreen=Capture image from full Screen.
CaptureHotKeySetup=Change hot Key using at capture.
CaptureWindow=Capture image from window.
EditCopyDisplayImage=Copy display image.
EditCopy32bpp=Copy selected area as 32 bpp pixel format.
EditCopy=Copy selected area.
EditCut=Copy and delete selected area.
EditDelete=Delete selected area.
EditDuplicateImages=Duplicate each image on layers.
EditFill=Fill selected area.
EditGroupedRedo=Redo actions in a group.
EditGroupedUndo=Undo actions in a group.
EditImport=Import an image from a file.
EditInvertSelection=Invert selection.
EditMoveSelectionDown=Move selected area to bottom.
EditMoveSelectionLeft=Move selected area to left.
EditMoveSelectionRight=Move selected area to right.
EditMoveSelectionUp=Move selected area to top.
EditPaste=Paste clipboard data to the image.
EditPasteLayer=Paste clipboard data to a new layer.
EditPasteNewImage=Create a new image from clipboard data.
EditPickColorFromCurrentLayer=Pick color at the cursor from current layer.
EditPickColor=Pick color at the cursor.
EditPickSecondColorFromCurrentLayer=Pick color at the cursor from current layer as second color.
EditPickSecondColor=Pick color at the cursor as second color.
EditRedo=Redo an action.
EditSelectAllLayers=Select all layers.
EditSelectAll=Select all.
EditUndo=Undo an action.
EditExpandSelection=Expand Selection.
EditContractSelection=Contract Selection.
EditStroke=Stroke=Trace a colored outline around a selection.
EditDeselect=Deselect all.
EditMoveSelectionLeftEdge=Move selected area to left edge.
EditMoveSelectionHorizontalCenter=Move selected area to horizontal center.
EditMoveSelectionRightEdge=Move selected area to right.
EditMoveSelectionTopEdge=Move selected area to top edge.
EditMoveSelectionVerticalCenter=Move selected area to vertical center.
EditMoveSelectionBottomEdge=Move selected area to bottom edge.
FileAcquire=Acquire an image from a TWAIN device.
FileBatchConversion=Convert numerous files at one time.
FileBrowse=Browse through images on disk.
FileClose=Close current image.
FileExit=Exit application.
FileExport=Save current image as other format.
FileImportFromCombinedImage=Import from combined image.
FileImportFromMultiFiles=Import from multiple files.
FileNew=Create new image.
FileOpen=Open image file.
FilePreferences=Customize application environment.
FilePrint=Print the image.
FilePrinterSetup=Change your printer settings.
FileProperties=Edit the image properties.
FileSaveACopy=Save a copy of current image.
FileSaveAll=Save all images.
FileSaveAs=Save current image to disk as a new file.
FileSave=Save current image to disk.
FileSelectSource=Select TWAIN device.
FrameAdd=Add a new frame.
FrameInsertIntoLeft=Insert a new frame into the left of a current frame.
FrameInsertIntoRight=Insert a new frame into the right of a current frame.
FrameBackFrame=Set active frame back.
FrameCopy=Copy selected frames.
FrameCut=Copy and delete selected frames.
FrameDelete=Delete selected frames.
FrameDuplicate=Duplicate a frame.
FrameDuplicateIntoLeft=Duplicate a frame to the left of a current frame.
FrameDuplicateIntoRight=Duplicate a frame to the right of a current frame.
FrameForwardFrame=Set active frame ahead.
FrameMerge=Merge frames from clipboard into the current image.
FramePasteToLeft=Paste to the left of a current frame from clipboard.
FramePasteToRight=Paste to the right of a current frame from clipboard.
FramePause=Stop animation of preview.
FramePlay=Play animation of preview.
FrameProperties=Edit the current frame properties.
FrameReverse=Reverse the order of the frames.
FramePlayFromFirstFrame=Play from the first frame.
FramePlayFromCurrentFrame=Play from the current frame.
HelpAbout=Show version information.
HelpContents=Open help file.
HelpCheckForUpdate=Check for new version.
ImageAddAlphaChannel=Set alpha channel to the current layer.
ImageAdjustColor=Adjust color of the image.
ImageCountColorsUsed=Count the number of unique colors used.
ImageDeleteAlphaChannel=Delete alpha channel from the current layer.
ImageDuplicateAlphaChannel=Create an image from alpha channel.
ImageEffect=Add special effect to the image.
ImageFlipHorizontal=Flip the image horizontal.
ImageFlipVertical=Flip the image vertical.
ImageGrayscale=Change the image to grayscale.
ImageInvertAlphaChannel=Invert alpha channel in the current layer.
ImageMakeAlphaChannel=Make alpha channel to the current layer.
ImageNegative=Change the image to negative.
ImageRotateBy90Degrees=Rotate the image by 90 degrees.
ImageRotate=Rotate the image.
ImageScrollDown=Roll the image to bottom.
ImageScrollLeft=Roll the image to left.
ImageScrollRight=Roll the image to right.
ImageScrollUp=Roll the image to top.
ImageScroll=Roll the image.
ImageSlope=Slope the image.
LayerAdd=Add a new layer.
LayerCombine=Combine visible layers.
LayerCombineDown=Combine the current layer and the one beneath it.
LayerDelete=Delete the current layer.
LayerDuplicate=Duplicate the current layer.
LayerLockAllAllLayers=Lock all layers of all frames.
LayerLockAllCurrentFrameLayers=Lock all layers of the current frame.
LayerLockTransparentAllLayers=Lock transparent pixels in all layers of all frames.
LayerLockTransparentCurrentFrameLayers=Lock transparent pixels in all layers of the current frame.
LayerNotLockAllLayers=Unlock all layers of all frames.
LayerNotLockCurrentFrameLayers=Unlock all layers of the current frame.
LayerNextLayer=Set active layer ahead.
LayerPreviousLayer=Set active layer back.
LayerPropertiesWithSameName=Edit properties of layers with same name.
LayerProperties=Edit properties of the current layer.
LayerReverseVisibilityWithSameName=Reverse visibility of layers with same name.
LayerReverseVisibility=Reverse visibility of all layers of all frames.
LayerMoveUp=Move the current layer up
LayerMoveDown=Move the current layer down
PaintModeClear=Eraser mode.
PaintModeNormal=Painting mode.
PaintModeOpacity=Opacity mode.
PaletteCopyRGBValue=Copy RGB value to clipboard.
PaletteCopyRGBValues=Copy RGB values between first color and second color to clipboard.
PaletteDefaultPalette=Initialize color palette with default values.
PaletteDeleteUnused=Remove unused colors.
PaletteLoadPalette=Load color palette from a file.
PaletteMakeGradation=Make color gradation between the first color and the second color.
PalettePasteRGBValue=Paste color values from clipboard.
PaletteReloadPenTile=Reload pen and tile files.
PaletteOpenPenTileFolder=Open the folder for pen and tile files.
PaletteSavePalette=Save color palette into the disk.
PaletteSelectTransparentColorToFirstColor=Select the transparent color of the current layer as the first color.
PaletteSelectTransparentColorToSecondColor=Select the transparent color of the current layer as the second color.
PaletteSwapColor=Swap the first color for the second color.
PaletteUniformColors=Uniform the colors in images with 1,4,8 bpp format.
PaletteUniteDupli=Unite duplicated colors.
ToolAntialias=Switch antialias effect.
ToolColorReplacer=Replace the second color with the first color.
ToolColorSelection=Create a selection by pixels with specified color.
ToolConnectLine=Draw connected lines.
ToolFilledOval=Draw a filled oval.
ToolFilledRectangle=Draw a filled rectangle.
ToolFloodFill=Fill the region enclosed by same color.
ToolLasso=Create a selection by freehand.
ToolMagicWand=Create a selection in the region enclosed by specified color.
ToolMover=Move visible area.
ToolOvalSelection=Create a oval selection.
ToolOval=Draw oval line.
ToolPen=Draw pixels by freehand.
ToolRectangle=Draw rectangular line.
ToolRectangularSelection=Create a rectangular selection.
ToolSplineCurve=Draw lines by spline.
ToolText=Draw a text.
ToolTransparent=Switch transparent effect when moving selected image.
ToolZoom=Change the magnification.
ViewActualSize=view the image with no zoom.
ViewFrame=Switch the visibility of the Frame window.
ViewGrid=Switch the visibility of the grid.
ViewHistory=Switch the visibility of the History window.
ViewLayer=Switch the visibility of the Layer window.
ViewLoupe=Switch the visibility of the Loupe window.
ViewOnionSkin=Switch the visibility of the onion-skin.
ViewPalette=Switch the visibility of the Palette window.
ViewPreview=Switch the visibility of the Preview window.
ViewSelectedLine=Switch the visibility of a selection line.
ViewSnap=Switch the effect of a snap.
ViewToolbarFrame=Switch the visibility of the Frame toolbar.
ViewToolbarLayer=Switch the visibility of the Layer toolbar.
ViewToolbarMain=Switch the visibility of the Main toolbar.
ViewToolbarTool=Switch the visibility of the Tool toolbar.
ViewZoomInResizeWindow=Zoom in on the image and resize window.
ViewZoomIn=Zoom in on the image.
ViewZoomOutResizeWindow=Zoom out on the image and resize window.
ViewZoomOut=Zoom out on the image.
ViewCustomGrid=Switch the visibility of the Custom-Grid.
WindowArrangeIcons=Arrange icons.
WindowCascade=Cascade windows.
WindowCloseAll=Close all windows.
WindowDuplicate=Duplicate the current window.
WindowFitToImage=Fit the window to the image.
WindowSeparateAnimatedArea=Separate the image into animation and static image.
WindowTileHorizontal=Arrange windows horizontally.
WindowTileVertical=Arrange windows vertically.
PreviewZoom25=Zoom to 25%
PreviewZoom50=Zoom to 50%
PreviewZoom100=Zoom to 100%
PreviewZoom200=Zoom to 200%
PreviewZoom300=Zoom to 300%
PreviewZoom400=Zoom to 400%
PreviewZoom800=Zoom to 800%
PreviewSpeedSlowest=Playback Speed Slowest
PreviewSpeedSlower=Playback Speed Slower
PreviewSpeedActual=Playback Speed Actual
PreviewSpeedFaster=Playback Speed Faster
PreviewSpeedFastest=Playback Speed Fastest
PreviewSequenceForward=Forward Playback
PreviewSequenceReverse=Reverse Playback
PreviewSequenceForwardAndReverse=Forward and Reverse Playback
PreviewSequenceRepeatSection=Edit Repeat Section
PreviewSequenceDeleteRepeatSection=Delete Repeat Section
PreviewTile=Tile
PreviewFillBGColor=Fill with Background Color
ToolExecuteFloodFill=Execute flood fill at the mouse cursor position.

[Browser]
SearchAaborted=Search was aborted because the number of files ran up to %d.
SearchingFiles=Searching files...
PreviewOperate=Drag=Move Left-Click=Close Right-Click=Menu
CopyImage=Copy Image
CopyPath=Copy Path
OpenFile=Open File
OpenFolder=Open Folder
PauseAnimation=Pause Animation
ForwardFrame=Forward Frame
BackFrame=Back Frame
OpenGale=Open with GraphicsGale
ZoomIn=Zoom In
ZoomOut=Zoom Out
KeepCurrentStatus=Keep Current Status
IncludeSubfolder=Include Subfolder
NotIncludeSubfolder=Not Include Subfolder
ManageBookmarks=Manage Bookmarks
Jump=Jump
Subfolder=Subfolder
MaxNumberSearch=Maximum Number of Searchable Files
NotifyNumberReachedMax=Notify The Number Reached The Maximum
MaxFileSizeAnime=Maximum File Size Displayable as Animation
MagnifySmalImage=Magnify Small Image
RunAnimationAfterAllRead=Run Animation After All Images Are Read
AutoZoominPreviewWindow=Auto Zoom In Preview Window
SameFolderExists=Same folder already exists. Would you like to add?
MyDocuments=My Documents
Desktop=Desktop
Detail=Detail
Small=Small
Medium=Medium
Large=Large
HighQuality=High Quality
BrowseFolder=Browse Folder
IncludeSubfolder=Include Subfolder
AnimationPreview=Animation Preview
Extension=Ext.
Modified=Modified
Refresh=Refresh
AddBookmark=Add to Bookmarks
InputNewName=Input New Name
Rename=Rename
KeepCurrentStatus=Keep Current Status
IncludeSubfolder=Include Subfolder
NotIncludeSubfolder=Not Include Subfolder
FitImageToWindow=Fit Image to Window
AutoRefresh=Auto Refresh

[Pen]
Sensitivity=Sensitivity
Desensitize=&Desensitize
ExceptWhenMouseButtonIsReleased=&Except when mouse button is released

[Backup]
Caption=Backup
ErrorFolderNotExist=Backup Error : Folder for backup does not exist.
ErrorCantDeleteFile=Backup Error : File could not be deleted.
ErrorCantRenameFile=Backup Error : File could not be renamed.
ErrorCantCopyFile=Backup Error : File could not be copied.
InitializeBackupFolder=Following folder was set as folder for backup.\n%s\nFolder for backup can be changed in Preferences.
CreateBackup=Creates a backup when saving a file.
FolderForBackup=Folder for backup
Generations=Number of generations

[AutoSave]
Caption=Auto save
ErrorFolderNotExist=Auto Save Error : Folder for auto save does not exist.
SavesAutomaticallyInEdting=Saves automatically in editing
FolderForAutoSave=Folder for auto save
CountOfActionsUntilSave=Count of actions until save
InClosingAFile=In closing a file
DoesNotSave=Does not save
SavesAll=Saves all
SavesExistentFilesOnly=Saves existent files only

[ExpandSelection]
ExpandBy=&Expand By

[ContractSelection]
ContractBy=&Contract By

[Stroke]
Stroke=Stroke
Contents=&Contents:
Location=Location
Inside=&Inside
Center=&Center
Outside=&Outside

[ToolHint]
AddSelection=Add a selection
SubtractSelection=Subtract from a selection
InSquare=In a square
MoveVerticallyOrHorizontally=Move vertically or horizontally
KeepAspectRatio=Keep aspect ratio
RotateBy45Degrees=Rotate by 45 degrees
VerticalOrHorizontalLine=Vertical or horizontal line
StairstepLine=Stairstep line
CancelLastVertex=Cancel last vertex
PickUpColorFromCurrentLayer=Pick up color from current layer
PickUpColorAsSecondColor=Pick up color as second color

[Preview]
PlaybackSequence=Playback Sequence
Forward=Forward
Reverse=Reverse
ForwardAndReverse=Forward and Reverse
RepeatSection=Repeat Section
DeleteRepeatSection=Delete Repeat Section
StartFrame=Start Frame
EndFrame=End Frame
LastFrame=Last Frame
FitWindowToImage=Fit Window To Image
FillWithBackgroundColor=Fill with Background Color

[New]
Format1=1bit(2colors)
Format4=4bit(16colors)
Format8=8bit(256colors)
Format15=15bit(32000colors)
Format16=16bit(64000colors)
Format24=24bit(Full color)
Format32=32bit(Full color + Alpha channel)

[Layer]
HintVisible=Layer visibility
HintAlphaChannel=Turns alpha channel on or off
HintProperties=Properties
HintUnlock=Unlock
HintLock=Lock
HintLockTransparentPixels=Lock transparent pixels
