Речник от книгата-учебник „Информатика - 9. клас“ от Петър Бърнев, Георги Тотков, Росица Донева, Владимир Шкуртов, Коста Гъров. Издателство „Летера“ - Пловдив, 2001 г. ISBN: 954-516-325-9.

I. Използвани съкращения
АЛУ = аритметико-логическо устройство
БД = база от данни
БПО = базово програмно осигуряване
БС = бройна система
ГПИ = графичен потребителски интерфейс
ДОС (MS-DOS) = дискова операционна система
ЕП = език за програмиране
ЕТ = електронна таблица
ИС = информационна система
ИТ = информационни технологии
КИ = компютърна информатика
КС = компютърна система
КТ = компютърна техника
ЛМ = локална мрежа
ОП = оперативна памет
ОС = операционна система
ППО = приложно програмно осигуряване
ПУ = периферно устройство
СУБД = система за управление на база от данни
УУ = управляващо устройство
ЦП = централен процесор
RAM = памет за писане и четене (Random Access Memory)
ROM = постоянна памет (Read Only Memory)


II. Кратък българско-английски речник
Английски термин = български термин

computer science = компютърна информатика
information = информация (произлиза от латинската дума <i>informatio</i> - сведение, изложение, разяснение
multimedia = мултимедия
message = съобщение
notification = известие, съобщение
object = обект
information society = информационно общество
informatics = информатика
information process = информационен процес
computer = компютър, изчислител, ЕИМ (електронна изчислителна машина - в контраст с А(М)ИМ - аналогова (механична) изчислителна машина)
computer science = компютърна информатика (КИ)
processing information = обработване (обработка) на информация
disseminating information = разпространяване на информация
gathering information = събиране на информация
storaging/storing information = съхраняване на информация
algorithm = алгоритъм (произлиза от името на Абу Джафар Мохамед ибн Муса <i>ал-Хорезми_</i> (al-gorezmi) - арабски математик, който около 820 г. от н. е. написва научен трактат за това как да се представят (записват) числата в 10-ична бройна система и как да се смята с тези представяния (reprensention; positional numeric(al) system)... стр. 26 + снимката)
subalgorithm = подалгоритъм
:= = присвояване, „присвоява стойност“ (термин от програмирането)
primitive operation = елементарно действие
step = стъпка
~
discrete = дискретен
efficiency = ефективност
computability = изпълнимост (изчислимост)
finiteness = крайност
determinism = определеност; 2. детерминизъм (термин от философията)
formality = формалност
clarity = яснота
~
number system = бройна система
binary system = двоична бройна система
decimal system = десетична бройна система
natural number = естествено число
digit = цифра
(digital = цифров, дигитален (най-често о(бо)значава „двоичен електронен“ в контекста на съвременните компютри и компютърни устройства)
template = шаблон, образец
pattern = образец, шаблон, модел, макет, скица; „патърн“; зависимост)
logic = логика (математическата (формална) логика) - стр. 41
binary logic = двузначна (бинарна, двоична) логика (в математическата (формална) логика)
relation AND = отношение „И“ (в математическата (формална) логика)
relation OR = отношение „ИЛИ“ (в математическата (формална) логика)
relation NOT = отношение „НЕ“ (в математическата (формална) логика)
(relation XOR = отношение обърнато „ИЛИ“ ?!?) (в математическата (формална) логика)
compound preposition = сложно (съставно) съждение (в математическата (формална) логика)
proposition = съждение (в математическата (формална) логика)
~
alphabet = азбука
bit (binary digit) = бит (двоичен разряд)
byte = байт (нарича се още и octet = октет (м. р.))
decoding = декодиране
(encoding = кодиране; шифроване)
code = код
coding = кодиране (често в съвремието се използва погрешно като синоним на „програмиране“ - „Аз кодя...“ вместо „Програмирам (нещо на компютър - на език на/за програмиране)...“)
(software (sw) = програмна част на компютър („мека“-техника), управляващ и контролиращ хардура:
програмно осигуряване (ПО) - (1) базов софтуер (базово програмно осигуряване (БПО)): операционни системи, инструментални средства (средства за разработка и средства за експлоатация), интерфейс (... означава „взаимодействие, допирни точки“, в буквален превод: „междулицие“) + (2) приложен софтуер (application software, app) (приложно програмно осигуряване (ППО)): потребителски, фирмен: средства за разработка и средства за експлоатация...
hardware (hw) = апаратна част на компютър (изчислителна техника), включително периферия)
(data = данни - съхранявани върху различни периферни устройства и използвани от софтуера)
abacus = абак (от гръцки - сметачна дъска), сметало
tablet /tablIt/ = таблет, плочка, плочица, дъска, дъсчица)
smartphone = смартфон, „умен“ телефон
smartwatch = смартуоч, „умен“ часовник
ОП, оперативна памет (наричана още основна (първична) памет
ИС, интегрална схема)
RAM = от англ. Random Access Memory (памет с произволен достъп); изменяема памет; памет за писане и четене
ROM = от англ. Read Only Memory (памет само за четене); постоянна памет
HDD (hard disk drive) = външен (магнитен) твърд диск [снимка тук] (външна (вторична) памет)
screenshot = екранна снимка, снимка на екрана, „екран“, „екраноснимка“, скрийншот
disc = носител на информация тип диск (като CD-R CD-ROM, CD+ROM, DVD-ROM, DVD+ROM и т.н.)
disk = носител на информация тип диск (HDD, SSD и т.н.))
ENIAC = Electronic Numerical Integrator And Computer (електронен числов интегратор и компютър)
~
address = адрес
input device = входно устройство
auxiliary (secondary) memory = външна (вторична) памет
floppy disk (diskette) = гъвкав диск, флопи диск
random access memory (RAM) = изменяема памет
cell = клетка
microprocessor = микропроцесор
main (primary) memory = оперативна (първична) памет
peripheral devices = периферни устройства
real only memory (ROM) = постоянна памет
hard disk = твърд диск
central processing unit (CPU /си-пи-ю/) = централен процесор (ЦП), процесор („ЦПУ /це-пе-ю/ /цъ-пъ-ю/ = централно обработващо устройство“)
(graphics processing unit (GPU) /джи-пи-ю/ = графична карта, видео карта, (ГПУ /ге-пе-ю/ /гъ-пъ-ю/ = графично обработващо устройство - обработващо графиката (визуализацията) устройство)
bus = шина
(port = шлюз, порт (метафорично пренасяне от морско-пристанищния термин „шлюз“) - в компютърните мрежи и в ОС/OS се означават с числа от 0 до 9999 (?!?)
modem (MOdulator-DEModulator) = модем (МОдулатор-ДЕМодулатор)
контролер (наричан още „периферен адаптер“))
~
(СУБД = система за управление на база/бази от данни
dev(elopment) environment, IDE (integrated development(al) enrivornment) = среди за програмиране (системи за програмиране)
utilities, utility app = средства за експлоатация (сервизни програми)
driver = драйвер (програмите, управляващи ПУ (периферните устройства = peripherals))
system services = инструментален софтуер
interpreter = интерпретатор (в буквален превод: „тълкувател“)
compiler = компилатор
software = програмно осигуряване, софтуер, програма (за компютър/компютри)
utility program (utility app) = сервизна програма
programming environment = среда за програмиране
translator = транслатор; 2. преводач (човек, който превежда по-гладко и на човешко-разбираем език; или софтуер и/или хардуер за груб машинен превод)
~
TCP/IP = от англ. <i><b>T</b>ransmission <b>C</b>ontrol <b>P</b>rotocol</i> --- протокол за управление на предаването/междумрежов протокол
(работни станции (workstations), файлов сървър (file server), сървър за печат (print(ing) server), server = сървър („сервиращ“, служещ), концентратор, потребителски компютри, комуникационен сървър; сървър 1)
(IPv4 = 4-байтов (4-октетов адрес: 31.34.343.234)
USB flashstick = USB флаш устройство, „флашка“)
(email, e-mail = електронна поща, ел. поща, е-поща, имейл)
(WWW = от англ. World Wide Web - Световна мрежа/паяжина)
text = текст (вкл. цифров/електронен текст)
image, graphics, picture = графично изображение, картина, картинка
audio = музикални записи, аудиозаписи/аудио-записи/аудио записи, речеви/гласови записи...
webpage = уебстраница (страница в даден уебсайт (в дадено „място в Мрежата“)
website = уебсайт („място в Мрежата“)
hypertext = хипертекст
hypermedia = хипермедия
HTML = от англ. HyperText Markup Language - език за описание (маркиране, отбелязване) на хипертекст (стр. 78)
(selection = селекция, избрана област, избрано, избор, избиране (като част от ГПИ на програма за създаване (рисуване - draw, paint) и редактиране на изображения/картинки)
web-search engine = търсеща програма (наричани на компютърен жаргон „търсачки“ --- КОМПЮТЪРЕН ЖАРГОН)
keyword = ключова дума (при търсене например в уеб-търсачка като Google Websearch, Yahoo! Search, Microsoft Bing, DuckDuckGo, ixquick.com, ...AltaVista, Excite, HotBot, Infoseek, Lycos, WebCrawler и т.н.)
(expression = словосъчетание, излияние, експресия, изливане (на себе си))
wide area network (WAN) = глобална мрежа (?)
e-mail/email = електронна поща
local area network (LAN) = локална (местна) мрежа (ЛМ)
hypertext = хипертекст
~
operating system (OS /ou-es/) = операционна система
commandline = команден интерпретатор, shell, terminal (терминал)
graphical user interface (GUI /dji-ju-aI/ /gu-i/) = графичен потребителски интерфейс (ГПИ)
filesystem = файлова система
kernel = ядро (на операционна система)
modify = променям, изменям, модифицирам - Modified: = Последна промяна/променен(о) на/
справочник на файловете (наричан още „каталог“ или „папка“ на файловете)
filepath = път на достъп до файла, път, файлов път, файлов адрес, адрес на файла
главният справочник (корен; безименен главен справочник) = root = "/" (*NIX/UNIX/LINUX), "\" (MS DOS, MS Windows)
справочници, които нямат подсправочници (наричани още <i>листа</i>))
main (root) directory/folder = главен справочник/папка
interface = интерфейс
operating system = операционна система
subdirectory (subdir)/subfolder = подсправочник/подпапка/„поддиректория“
path = път
directory/folder = справочник/папка/„директория“
file = файл
file system (filesystem) = файлова система
~
WIMP-интерфейс = от англ.: <i><b>W</b>indows</i> (прозорци), <i><b>I</b>cons</i> (икони), <i><b>M</b>ouse</i> (мишка), <i><b>P</b>ull-down menus</i> (падащи менюта) - стр. 90 - Xerox (1960-те) / Palo Alto
cursor = показалец (маркер), курсо`р
single-click (LMB) = изборът се извършва, като с помощта на мишката екранен показалец (маркер, курсор) се придвижва върху съответния обект (например икона) и се натисне (с бързо отпускане) бутон на мишката - един път (наричано на компютърен жаргон „щракване“)
double-click (2xLMB) = наричано на компютърен жаргон „двойно щракване“
display = екран, монитор; 2. показаното (визуализираното на екрана на монитора)
window (GUI) = прозорец (ГПИ)
tab (GUI) = подпрозорец (ГПИ)
title bar (GUI) = заглавна ивица/лента - (с името на използваното приложение (програма) и името на документа, който се редактира или създава чрез това приложение (стр. 90)
main menu (GUI) = ивица/лента с главо (хоризонтално) меню, главно/основно меню (ГПИ)
управляващи икони - за оразмеряване (resize) [], максимизиране (прозорецът да заеме целия дисплей) [увеличи, увеличаване], минимизиране (смалява (редуцира) прозореца до икона в taskbar-а (лентата със задачи) [намаляване]) и затваряне [затвори] на прозореца (приключване на работата с приложението);
toolbar = лента/ивица с инструменти (съдържаща икони, които при избор извършват някои често изпълнявани дейности (например запазване или отпечатване (печат) на документа) + средство за Помощ, достъпно от ивицата/лентата с хоризонтално меню, предоставящо подробна информация за приложението, неговите компоненти и начини за работа с тях...
file manager = файлов мениджър, програма за работа с файлове и справочници (папки, директории)
програма за графично проектиране - като CorelDRAW
програма за текстообработка (word processing) - като Microsoft Word
drag & drop = посочване, захващане и влачене... влачене и пускане (операция с курсора на мишката) - стр. 92 - 
control panel = контролен панел, управляващ пулт
Recycle Bin = кошче за отпадъци
[+]/[-] = expand/collapse = разгръщане/свиване (отваряне и закриване)
навигатор = hdd/ssd/peripherals/network/search/etc. част от файлов мениджър
crop = подрязване до [границите на] избраната област (селекция)
cut = изрязване
copy = копиране (drag&drop)
paste = поставяне, (залеп(в)яне, пускане)
move = преместване (Shift + drag&drop)
delete = изтриване, (премахване) [shift+delete = окончателно изтриване, което пропуска възможността за последващо възстановяване чрез кошчето за изтрити файлове / кошчето за отпадъци (Recycle Bin)]
restore/recovery = възстановяване
rename = преименуване
create new folder = създаване на нови каталози във всяка точка от дървото на справочниците
Ln = line = ред (в програма за създаване и редактиране на текст, в текстообработваща програма и в Excel - програми за ел. таблици с математическо-финансови функции-алгоритми)
Col = column = колона
Sel = selection = селекция
Sel Ln = 
UTF-8(-BOMless)
UTF-8-BOM
X,Y КБ = X.Y KB (kB, kb) vs. X,Y КиБ (kB, kb) = X.Y KiB/kiB ==== двоични срещу десетични измервателни единици за количество (компютърна) информация
~
graphical user interface (GUI) = графичен потребителски интерфейс (ГПИ)
window (GUI) = прозорец (ГПИ)
mouse (GUI) = мишка (ГПИ)
icon (GUI) = икона (ГПИ)
pull-down menu (GUI) = падащо меню (ГПИ)
Пример на/за ОС с ГПИ е системата Windows на фирмата Microsoft („микро-софт(уе(Ъ)р)“, „микромеки“)
форматиране, редактиране, страниране
computer-aided drawing (CAD) = компютърно подпомагано рисуване (на архитектурни или product-design продукти и за проектиране на промишлени (индустриални) продукти/стоки)
графично приложение = graphics app
приложение за работа с ЕТ (електронни таблици) = electronic tables (MS Office Excel, GNU Calc)
~
user program = потребителска програма
application software = приложен софтуер
application program = приложна програма
common purpose software = софтуер с общо предназначение
special purpose software = софтуер със специализирано предназначение
commercial software = фирмен софтуер, плате`н софтуер, собственически (proprietary) софтуер
computer graphics = компютърна графика
програ`мен продукт
програ`мен пакет = software package (e.g. 
word wrap = пренасяне на редове, „писане на редове с размера на прозореца“ (стр. 106)
готови _геометрични фигури/форми_ (Shapes Tool in paint.net ~BGlocalize & https://github.com/sahwar/Bulogos ): 
text inputting = въвеждане на текст
feature = (налична) възможност, (налична) функционалност, екстра; (налична) опция, (налична) функция,
properties (GUI) = свойства (ГПИ)
drawing/painting tools = инструменти за рисуване - четки, моливи, спрей
toolbar (GUI) = лента с инструменти (ГПИ)
font style = начертание (???)
font size = размер на знаковете (кегел)
<b>Bold</b> = почерняне, удебелен (текст), „болднат(о)“
<i>Italic</i> = <i>накланяне</i>, курсив(но), италик
<u>Underline(d)</u> = <u>подчертаване</u>
select = селекция/избиране (маркиране) на част/област от изображението
flip/rotate = обръщане/въртене на изображението (или на маркирана негова част)
image size = промяна на Размер(ите) на изображението
canvas size = промяна на Размера на платното [за рисуване]
eraser (GUI) = гумичка за изтриване (с/към прозрачен „цвят“)
paintbrush = честа с боя (бои) за рисуване
чертане/чертежи
Set Font = Настройка на шрифта
font = шрифт (= набор от едностилни решения за графичното начертание на буквите, препинателните (пунктуационните, пунктуация) знаци и др.)
color select = показалец, с който се избира даден цвят (цветова пипетка)
zoom = лупа (с която увеличавате/намалявате изображението на екрана, без да променяте действителните му размери) ~BGlocalize ~to add to github.com/sahwar/Bulogos
to set = задавам (дадена настройка/опция)
(Можете да зададете различна дебелина и наклон на четката, гъстота на точките на спрея, дебелина на линията, запълване на контури и др.
text insertion = вмъкване на текст
INS = insert mode = режим на „вмъкване“ (ВМК), при който не се изтрива следващия знак, ако сложите курсора в средата на дума (текстов низ, ограден с празно пространство (интервал, шпация - клавиша Space)) и въведете знак/текст - за разлика от режима OVERWRITE (OVR / OVW) - тези режими се сменят с клавиша Insert (Ins) от клавиатурата
(промяна на размерите, фона, наклона, задаване на черно-бяло или цветно изображение и др.)
~
to set = задаване, зададен...
calculator = калкулатор, (електронен или механичен или друг) изчислител (изчислителна машина) - често на български се използва и жаргонната дума „елка“ като синоним на малкия ръчен преносим калкулатор - по името на известната марка български малки ръчни преносими калкулатори ЕЛКА (ELKA) от близкото минало (от епохата на соца/социализма)
textprocessing (text processing, text-processing) = текстообработка
color (BrE: colour) = цвят
font = шрифт, (шрифтове начертание) ~BGlocalize ~paint.net_BG by ve4ernik/sahwar
долен индекс (долен степенен показател) в математиката - указва в коя бройна система е представено дадено число - например 1601<sub>16</sub> означава, че е представено числото „1601“ (= XYZ в 10-ичната бройна система) в 16-ичната бройна система
textEdit field = полето 
„визуализира се в “
(вмъкване на текущата дата и време...)
button = бутон, клавиш, копче
console = конзола
terminal = терминал (например cmd.exe при/в MS (Microsoft) Windows или bash в Terminal при/в/под (GNU/)Linux/LiGNUx
„Какви възможности предлага приложната програма <i><b>Notepad</b></i>{green-color}?“
utilities = сервизни (обслужващи) програми
(computing/calculating... = пресмятане/изчисляване/изчисление.../калкулиране... числени пресмятания (+ логически изчисления...?)
Help = системната помощ Help
filecheck = проверка на файл (, съхраняван върху вградения диск, за да се установи изправността на съхраняваните данни и програми и да се узнаят евентуални нежелани изменения...)
checksum algorithm = алгоритъм за проверка на изчислена хеш/хаш сума (буквено-цифров ASCII низ
string = (текстов(и)) низ (най-често става дума за поредица от ASCII или UTF-8 знакове/знаци); substring = подниз
file compression = компресиране на файл(ове), сгъстяване (уплътняване) на данни (файлове)
file archival/archiving = файлово архивиране (архивиране на файл(ове) - дългосрочно съхраняване на данни (файлове) - казва се още архивиране на данни... 2. архивиране - компресиране на файл с програма за компресиране в компресиран файлов формат (файлово разширение) като .zip (.ZIP), .7z (.7ZIP), .rar, .tar.gz, .tar.xz, .arc и т.н.
computer virus = компютърни вирус; Trojan horses, rootkits, keyloggers (software&hardware, etc.))
fragmentation = фрагментиране (обратно на дефрагментиране - представлява накъсване на части)
defragmentation = дефрагментиране
init (initFreedom) = BIOS, UEFI и SysV/systemd/и др. т.н. - програма (или скрипт) за първоначално зареждане на операционната система
script = скрипт (например bash скрипт - скрипт за командния интерпретатор bash в ГПИ програмата терминал Terminal; 2. изходния код на програма в интерпретиращи езици за програмиране като Python - скрипт за Python / Python скрипт)
reset = връщане в начално (фабрично, подразбиращо се) състояние; нулиране
number sequence = числова редица
set = мат. множество; subset = подмножество; надмножество...
text replace = заменяне/замяна, заместване...
(remove = изтриване)
(move = местене, преместване...)
(„като подразбираме, че...)
digit = цифра (десет на брой в 10-ичната бройна система: 0 1 2 3 4 5 6 7 8 9)
number = число (поредица от цифри с дадена стойност, записани в дадена позиционна бройна система... или в друга...)
(hide = скриване)
„Програмата притежава лесен за усвояване ГПИ и добре организирана помощ (Help)“
(iconicity = иконичност (Metaphors We Live By...))
wizard (GUI) = съветник, магьосник (ГПИ) (?!?)
external media = външен (паметов) носител (на електронни цифрови данни)
opitical media = оптичен медиен носител, например CD-диск или DVD-диск или BluRay-диск
~
antivirus software = антивирусен софтуер
archive = архив
virus = вирус
packing = компресиране
utilities = сервизни (обслужващи) програми („[системни] инструменти“)
(term = термин, понятие... „Нямам си представа... Нямам си идея... Нямам си понятие...)
life cycle = жизнен цикъл
send = изпращане
submit = (из)пращане, пускане (например на коментар под статия в блог в Интернет)
(проучване и ползване)
computer document = компютърен документ... (стр. 115) --- Логическа структура на документа (като в TeX/LaTeX/XeTeX или в .doc/.docx & .odt / .odf ---
paragraph = абзац (параграф)... заглавие, глави, раздели, подраздели и т.н.
Номерация (номериране) в различни системи, например: 
1., 1.1., 1.2; 2., 2.1, 2.1.1., 2.1.2., ...; или I., I.1, I.2, ...; V.1., V.1.A., V.1.B., ... и др.;
hyperlink, link, URL/URI = хиперлинк (м.р.), линк, хипервръзка, връзка, препратка, е-препратка, ел. препратка, интернет адрес, е-адрес, ел. адрес, адрес в Интернет
редици за изброяване с различни водещи знаци, например - * .... a) ... I. ... 1. ... & ...
templates (MS Word, LibreOffice/OpenOffice.org) = шаблон (със зададено текстово-оформленческо форматиране); макетна структура (?!?) - стр. 116
frame = рамка
Логическа структура СРЕЩУ Макетна структура (горен колонтитул, текст 1, рамка 1, Таблица, Рамка 2, Долон колонтитул... Логическа структура: заглавие, поле за автоматично добавяне на датата и часа, абзац, рисунка 5, (поясняващ плаващ) текст към рисунка 5 (, закотвен под нея), таблица, текст, текст към абзац 9, абзац, автоматично номериране на страницата (РАЗЛИЧНИ СТИЛОВЕ/ФОРМАТИ... style guide...)
layout = оформление (графичната/визуална макетна структура на даден документ - в контраст (за разлика от) логическата му структура --- стр. 116
~
life cycle = жизнен цикъл
computer document = компютърен документ
logical structure = логическа структура
layout structure = макетна структура
citationstyles.org + Bulgarian citation styles from liternet.bg + BG books about citation... 'consistence is the hobgoblin of small minds (i.e. mathemathicians&programmers&physicist-scientists...)
content /AmE: xIPA; BrE: IPAx&X-SAMPA&Z-SAMPA/ = съдържание
~
(знак и специален знак - специални знаци - за крайн )
SMALL CAPS = МАЛКИ ГЛАВНИ БУКВИ
{копиране на цялата стр. 118 - за добавяне към https://github.com/sahwar/Bulogos/BLSG - Bulgarian-language style guide...}
... ~to add to https://github.com/sahwar/Bulogos/BLSG - Bulgarian-language style guide
съставна дума (дума, включваща в себе си тире или други знакове, например Експо'01)
преминаване на нов ред - автоматично (в текстообработваща програма или чрез Word Wrap в plaintext editor) или чрез натискане на клавиша Enter (въвеждане, вход) или Shift+Enter
специалните знаци имат служебни функции, които се използват за разделяне на елементите в документа. Пример за специални знаци са (често невидимите при графично редактиране чрез ГПИ, освен ако не е включена опцията за визуализирането/показването им) знаците за край на ред (EOL), абзац (параграф), раздел, страница и др.
набор (само за буквени знаци) - редовни (малки букви, минискул, минискюл (?) - lowercase), главни букви (мажискюл?!? - uppercase, ГЛАВНИ БУКВИ, МАЛКИ ГЛАВНИ БУКВИ и др.
големина (размер(и) или кегел на знаковете, височината на които се измерва в пунктове (1pt = 1/72 от инча, 1 инч = 2,54 cm (см) сентиментра)
... знак, специални (служебни) знаци, {характеристики (форматиране) на знака}, поле (елемент на документа, съдържанието на което се изчислява (получава) автоматично на базата на други елементи на документа или данни на компютърната система), дума (редица от знаци (най-често букви - при азбучните писмени системи (писмености)), която има смисъл в даден език... В европейските езици, използващи азбуки, думите се отделят една от друга чрез знак за пауза (интервал, шпация - Space клавиш, празно пространство, whitespace); ред и междуредове разстояние; 
word wrap = пренос на нов ред (!?!)
абзац (параграф) = текст, който се състои от едно или повече изречения... За отбелязване на края на абзац се натиска клавишът Enter...)
>>> Заглавията, надписите в горния и долния край на страницата (т. нар. горен и долен колонтитули), бележките под линия и др. също са абзаци, но оформени по специален начин...
*** Абзацът има редица характеристики като лява и дясна граница, отстъп (indent, настъп(?!?) outdent (?)), висене на първия ред над останалите (DropCaps), междуредово разстояние до съседните абзаци, подравняване (възможности: вляво (ляво), вдясно (дясно), центрирано и двустранно), декоративни елементи (черти, водачи, фон) и др.

Подравняване и изместване на абзац (параграф)
Подравняване | Представяне (визуализация)
Ляво
Двустранно, с отстъп на първия ред
Двустранно, с висене (настъп) на първия ред
Дясно
Центрирано
location = разположение, местоположение, локация, местонахождение
име, дата на създаване/изменение, размер и др. --- стр. 120
~
paragraph = абзац (параграф)
computer graphic(s) = (компютърна) графика
word = дума
character (съкр.: char) = знак
column (Col) = [вертикална] колона, стълб (в таблица - table („маса“))
row, line = [хоризонтален] ред (в координатната система на електронна таблица)
line (Ln) = [хоризонтален] ред
field = поле
section = раздел
table = таблица
~
Основните етапи при редактиране са:
* Първоначално въвеждане на текстови, графични или друг тип информационни елементи;
* Форматиране на елементи на документа;
* spellchecking = (автоматизирана) проверка за/на правописни и пунктуационни грешки;;;; проверка на граматическата коректност на текста, маркиране и номериране на последователни елементи и др.
* style editing = стилово редактиране;
* внасяне на корекции в документа.
clipboard = буферна памет (официален превод в/за Google Android v8/v9), системна памет (?!?), междинна памет, системен буфер, клипборд (по метафора с дъската за залепяне на хартиени бележки) --- място за временно съхранение на данни
Въвеждането се реализира в два режима --- с вмъкване (ВМК - INS - insert) или препокриване (ППК - OVR - overwrite) ~BGlocalize
преместване, копиране и заместване --- text select & Drag&Drop
text[ual] formatiing = [текстово] форматиране (оформяне)
~~
„оформяне на макетна структура“ = този етап на обработка на документ се нарича и с много други имена в практиката - „страниране“, „макетиране“, „компютърен дизайн“ и пр.
---
~~~
undo = (операцията за) _отмяна (връщане)_ на последното действие
redo (обратната на Undo операция / операцията, обратна на Undo) = възстановяване (повтаряне?)
File/Open / File -> Opem = File>Open = File > Open = File|Open = File | Open ... File (arrow) Open... = Отваряне (Отвори, Отворете)
File/Save = Запазване, Запис, Записване, Съхраняване
Save as... = Запис като..., Записване като..., Запазване като..., Съхраняване като...
~~~
insert = вмъкване
delete = изтриване
copy = копиране
move = преместване
overwrite = препокриване
edit = редактиране
format = форматиране; 2. формат; 3. file ~ = файлов формат (файлово разширение - .txt (8+3 за MS-DOS/Windows или .{неограничен-брой-или-до-128-или-256-или-512-или-1024-или-2048 знака/знаци... за/под/в LINUX)...)
('lawsetting' = законодател (?!?)
spelling (spellcheck(ing) = (автоматична) проверка на правописа [сравнява думите (низовете) в текста (а НЕ поднизовете!!! и поднизово търсене!) с предварително уж избран, подреден списък-речник с уж правилно написани (откъм официалния книжовен/книжовноезиков) правопис...]
table - worksheet (в MS Office Excel) = работен лист
(Например в софтуерния пакет Excel 5.0 таблиците може да имат до 256 колони и 16 384 реда...)
(графично представяне на данни - под формата на различни видове диаграми...)
number = число
currency = валута
date = дата
text = текст
$B$4 = пример за абсолютен адрес в програма за електронна таблица (ЕТ)
ET (написано на латиница) = extraterrestrial (alien from outside of the planet Earth), на кирилица: електронна таблица; ЕТ (юридическата фирма тип „едноличен търговец“; ЕООД (еднолично дружество с ограничена отговорност (ЕООД); ООД = дружество с ограничена отговорност...)
етикет за избор на (работен) лист = етикет, чрез който се избира лист от класьора за прехвърляне в работния прозорец (фиг. 2)
status bar = информационна лента, лента със/за статуса [част от прозореца, на която се показват данни за текущия режим на работа и за свойствата на обработвания документ]
класьор (или работна папка) - набор от листове, които се пазят във файл и се обработват заедно. В най-простия случай класьорът съдържа една таблица...
index = азбучен показалец, индекс (да НЕ се бърка с индекс в смисъл на подредов или надредов знак - използван в математиката, химията, физиката и като декоративно текстово форматиране!)
notation = нотация, система с условни означения (знаци със специално, служебно значение и функция...) = (система от условни знаци със специално, служебно значение, с които се обозначават например математически/химически/физични формули или съкращения в речници)
absolute address = абсолютен адрес (хипервръзка в HTML код от вида http://example.com/page/article.html или например „$B$4“ в ЕТ (електронна таблица) като MS Excel / GNU Calc)
relative address = относителен (релативен) адрес (хипервръзка в HTML код от вида '\page\article.html или например адрес като „B4“ в координатната система в програма за работа с ЕТ (електронна таблица) като MS Excel / GNU Calc
)
сменен адрес = стр. 130
делене, деление
~
address = адрес (в ЕТ (електронна таблица) като MS Excel / GNU Calc)
spreadsheet = електронна таблица (в ЕТ (електронна таблица) като MS Excel / GNU Calc)
workbook = класьор (работна папка) (в ЕТ (електронна таблица) като MS Excel / GNU Calc)
cell = клетка (в ЕТ (електронна таблица) като MS Excel / GNU Calc)
wizard = помощник (магьосник) - като Nullsoft NSIS (в ЕТ (електронна таблица) като MS Excel / GNU Calc)
worksheet = работен лист (в ЕТ (електронна таблица) като MS Excel / GNU Calc)
~
compatibility = съвместимост (способността на дадена програма (или хардуер) да работи успешно с дадена друга програма, или да работи успешно с определена операционна система, хардуерна конфигурация или firmware или софтуерен драйвер(и),)
(текст, число, дата, формула)
~~~
programming language = език за програмиране (ЕП)
(алгоритъм на Евклид, формули на Виет, Питагорова теорема, редици на Фибоначи и т.н.)
НОД = най-голям общ делител
~~~
loop = цикъл (повтаряща се група от елементарни действия)
~~~
>>>
input data = входни данни (предварително подготвени; ... наричат се още КОНТРОЛНИ ДАННИ)
output data = изходни данни
result = резултат
processing rule = правило за обработка
linear algorithm = линеен алгоритъм
sequential algorithm = последователен алгоритъм
cycle(, loop (?)) = цикъл
~~~
компютърни алгоритми
машинен език = machine code
assembly = 
машинна програма = machine-code program
асемблерни езици за програмиране
езици за програмиране от високо равнище/ниво
универсални езици за програмиране... = ? Turing-complete (?) whole-integer discrete
keywords (in a programming language) = служебни думи (ключови думи), синтаксис на даден език за програмиране (крайният набор от запазени думи, изрази и препинателни (пунктуационни, пунктуация) знаци/знакове със специално значение в иходния код на дадена програма...)
source code = изходен код, код-източник
developer (често съкращавано като dev - да не се бърка със съкращението на device) = разработчик, програмист (човек)
device (често съкращавано като dev - да не се бърка със съкращението на developer или development)
development = разработка (процесът по измислянето, структурирането и написването и тестването и дебъгването на дадена програма...)
to develop = разработвам (дадена компютърна програма или нещо друго, например продукт или реклама на продукт или услуга...)
~
programming language = език за програмиране
machine code (object code) [executable code] = изпълнима програма (?) - стр. 144
Pascal = (езикът за програмиране) Паскал
source code (program) = първоначална програма, изходен код (на дадена програма, най-често написан на език от високо равнище), код-източник
~~~
{обяснение за програмисти} = коментар на езика за програмиране Pascal
процесорно време = завъртания/цикли в секунда (???)
~~~
alphabet = азбука (един от видовете писмени системи (писмености) - writing systems / scripts)
statement = оператор
semantics = семантика
syntax = синтаксис
~~~
величини: константи и променливи
отношения (релации)
~~~
ASCII (American Standard Code for Information Interchange = Американския стандартен код за обмен (обмяна) на информация) - стр. 156
256 = множество с поредни кодове от 0 до 255 вкл. (включително)
' = апостроф
char(acter) type [стойностите на величините от знаков тип са елементи на крайно множество от знакове, между които се предполага, че е въведена наредба (ред, подредба, точно установен ред...)] = знаков тип (понякога погрешно наричан „символен тип“)
>>>
value = стойност...
constant = константа
domain = множество от стойности
operation = операция
variable = променлива
simple data type = прост тип данни
relation = релация
data type = тип данни (в език за програмиране: === типове и величини...)
~
(въвеждане, извеждане, присвояване... входен поток)... Възниква въпросът КАК И ЗАЩО и ДАЛИ...
~~~
[different types of] brackets nesting = ??? вложеност (нива, равнища, „дълбочинност“, дълбочина) на скобите
() = обикновени (полуелипсовидни) скоби (лява и дясна) --- с увеличаваща се/намаляваща големина и двойка броеве, т.е. nesting по големина/вложеност/дълбочинност/дълбочина (като представяне в TeX/LaTeX/XeTeX)?
[] = квадратни скоби (лява и дясна) --- с увеличаваща се/намаляваща големина и двойка броеве, т.е. nesting по големина/вложеност/дълбочинност/дълбочина (като представяне в TeX/LaTeX/XeTeX)?
{} = фигурни скоби (curly brackets на англ.) --- с увеличаваща се/намаляваща големина и двойка броеве, т.е. nesting по големина/вложеност/дълбочинност/дълбочина (като представяне в TeX/LaTeX/XeTeX)?
~~~
software engineering = софтуерно инженерство
read = въведи (чети) (в ЕП Pascal)
write = изведи (запиши) (в ЕП Pascal)
end = край (в ЕП Pascal)
begin = начало (в ЕП Pascal)
assignment = присвояване (в ЕП Pascal)
~~~
логически (булев, Boolean - по името на Дж. Бул) тип данни
if ... (..) then ... else = ако ..., то ... , иначе ...
~~~
if = ако (в ЕП Pascal)
decision making = вземане на решения
else = иначе
boolean/Boolean data type = логически тип данни
logical condition = логическо условие
then = то (тогава)
conditional statement = условен оператор
(IDE = 1. integrated development environment = интегрирана среда за програмиране... 2. ... (хардуер))
(инициализация, начало/стартиране/започване на алгоритъма (компютърната програма); проверка за край; тяло; управление на повторенията... подусловие)
~~
precondition = предусловие
postcondition = следусловие
loop statement = цикличен оператор
loop (или още cycle) = цикъл
(iteration = итерация, n-то на брой повторение (на същия алгоритъм))
(recursion = рекурсия)
(параметър, условие...)
~
(оператор for (в превод означава „за“.))
вложени цикли и вложени (nested) нива от скоби (вложеност, дълбочинност, дълбочина...) - стр. 197
(regex, regexp, regular expressions = регулярен израз, регулярни изрази)
wildcard = ? ...
~~~
nested loop = вложен цикъл - стр. 188
~~~
array = [тип] масив = тип данни в програмирането (и, съответно (respectively), в езиците за програмиране...) {размерност на масив, тип на индекса, елементи на масива... явно, неявно... явление, проявление/манифестация (manifestation...)}
tw-dimensional (2D, 2-D) array = двумерен масив (тип [от] данни в компютърното програмиране...)
index = индекс
dimension = 1. размерност (в типа данни „масив“ (array) в компютърното програмиране...); 2. измерение (1D, 2D, 3D, ...)
{алгоритми за търсене и броене}
(traversal = обхождане (в алгоритмите за търсене и броене...))
(((printLn = отпечатване, принтиране, извеждане на резултатите в писмен вид...)))
~
counting = броене
the greatest (maximal) element = най-голям елемент
searching = търсене
(хомогенност, еднотипност...)
~~~
(стр. 205 - електронен речник...)
~~~
string = низ (знаков низ) --- substring = подниз... Низът е подредена съвкупност (дискретна последователност) от краен брой знакове... string length = дължина на низа...
concatenation (concat) & to concatenate (to concat) = слепване, конкатенация (конкатениране)
(Caesar cipher = код на Цезар, Цезаров код, Цезаров шифър)
length = дължина
string length = дължина на низа
~~~
encryption = шифроване, криптиране
decryption = разшифроване, дешифроване, разкриптиране, декриптиране
coding = кодиране; 2. кодиране (= (жаргонно, шеговито) (компютърно) програмиране)
~~~
instruction = упътване, инструкция, указание, гид... style guide = стилово ръководство (ръководство за стила при писане и форматиране на текст на (съвременния) български(я) (що-годе горе-долу иде реч... почти... книжовен) език)
instruction set (CPU hardware term) = набор инструкции (възможности с flags) за ЦПУ (централния процесор)
(равнотипни... разнотипни... разнообразни... разтриване... разстояние... престояла храна... хищничество... ... ... угледен, неугледен...)
record = запис, (records = хроники...)... запис и поле (в ЕП Pascal)
~~~
nested records = вложени записи
record = запис
field = поле
~~~
magnetic tapes = магнитни ленти; магнитни дискове (HDD & SSD), floppy disk (diskettes) = дискети
~~~
file = картотека, файл (в шкаф с рафтове, като във всеки има картотека със съхранени папки с документи в тях...)
external memory = външна памет (магнитни ленти, магнитни твърди дискове, дискети, оптични (оптически) дискове, физическа хартия, камък, пластмаса и т.н.)
update = актуализиране, обновяване, обновление; „ъпдейт(ване)“
upgrade = надграждане, „ъпгрейдване“
download = 
upload = 
peer = пиър, p2p (пряко свързване между потребители... като в протокала .torrent или magnet link uri:magnet... или както и да е...)
(разпечатване на справки...)
(файлов указател...)
(входно-изходна операция...)
input-output (I/O, I-O, IO) = входно-изходна операция
(... извеждане на съобщение за грешка...)
parameter = параметър (мн. ч. - параметри)
(подалгоритъм (модул)???)
(encapsulation & self-contained & integer-based ANSI C (?!?) / Rust)
software engineering = софтуерно проектиране, софтуерно инженерство, (компютърна/компютърно) програмистка професия
implementation = реализация, имплементация, осъществяване
(... анализ и тълкуване... документиране...)
стр. 234 - изисквания към програмните системи...: правилност, точност, съвместимост, надеждност, универсалност, защитеност, полезност, ефективност, проверяемост, приспособяемост/приспособимост/адаптивност (адаптиране...)
~~~
analysis = анализ
documentation = документация
testing = проверка (на програми), тестване (QA = quality assurance) (на (компютърни) програми)
programming = програмиране
design = проектиране, дизайн
implementation = разработка (реализация)
software engineering = софтуерно инженерство
specification = спецификация
-
matches: ... = броя на срещанията на (под)низа във файла: ...
~~~
View = Изглед
Browse... = Преглед..., Разлистване..., Избиране..., Избор..., (Разглеждане...)

---
sketchfab.com

======
======
(в синьо) | (в зелено) | (в светложълто) | (в светлочервено/светлорозово) | (в бяло) 
термин на английски | препоръчителни преводи на български | приемливи преводи на български | непрепоръчителни преводи на български и англобългарски смесени идиосинкратични Englian/Bulgarianish/BulgEnglish (българийски, българо-английски смесени (пиджин) езици...) | Пояснения (вкл. с изображения, GIF анимации и дори видео със звук или аудио-файл, или друг тип файл), бележки, анотация и примери... ~BGlocalize; to add to https://github.com/sahwar/Bulogos
======
privacy = поверителност
---
подсигуреност... сигурност...
---

======
======

======================================
 --- с увеличаваща се/намаляваща големина и двойка броеве, т.е. nesting по големина/вложеност/дълбочинност/дълбочина (като представяне в TeX/LaTeX/XeTeX)?
======================================

................................................................................

======================================
„... Дуранкулак...“ - „върколак...“
„шамандурка“
---
Тя изпищя буйно / Тя буйно изпищя при вида на граматически сгрешеното изречение, с което той уж се опитваше да флиртува с нея... (?!?)

„позиционира файловия указател...“
---
seek & you shall find...
FileSeeker...
======================================
бъзик... урунгел... маймунджълъци... разточителство, прахосничество, разхищение = mono no aware (NO!!! another Japanese term (!!!))...
---
aUI - theanomalist.org - aUI - език на предполагаема извънземна раса или шега на вещ езиковед (лингвист)??? --- статия за parallelreality-bg.com ... ~to add to sixenius.wordpress.com & статията за Исландия като Атлантида и изследванията на sixenius/ve4ernik за Атлантида, частично заети от брой на списание „Наука и техника“...

---
(производни думи = derived word, derivatives = „деривати“, деривативи...)
(фигурно пързаляне... той бил изпързалян... подливал му водата... изиграл го... надиграл го... надцакал го... прецакал го... (само)прецакал се сам...
==============================
catfish, find, locate, 'hyperfind' --- find - search at github.com & gitlab.com
==============================
Да`ли на Салвадор Дали` да каже „Да ли?“... :P [езиковедски (лингвистичен) хумор]
---
неустойки, удръжки за данък общ доход...
---
настояща/текуща стойност
по- и най- и „по-по-най“... „Баш Майстора“
по големина СРЕЩУ
---
прости способи и средства... уред, апарат, машина, устройство, механизъм, хардуер
---
https://github.com/sahwar/Bulogos/BLSG - Bulgarian-language style guide
======
предимства <-> недостатъци; позитиви и негативи (положителни страни и отрицателни страни); Ян и Ин --- в ИнЯн
таблица -> таблиЧен --- ц -> ч (превръщания, преобразувания)
физични - срещу - физически
---
child of wisdom, child of Foolishness; God of Foolishness & MAD/CRAZY WISDOM
======
'Metaphors We Live By' (the book)
и др.
и пр. (прочие ИЛИ прочее (?!?)
и т.нар. ИЛИ и т. нар. (?!?
i.e. = т.е. (тоест)
e.g. = напр. (например, за пример, пример: , примерно: )
XXI в. = 21. в. = 21-и век (римски цифри и индийско-арабски цифри)
---
събиране (addition) = +
изваждане (substraction, deduction) = - (minus-hyphen, hyphen-minus)
умножение (multiplication) = * (или . или x (X) или {multiplication sign} или (без) около скоби)
деление (division) = / или : или {division sign} (HTML: ... Unicode hex: ...)
(изчисляване на) процент = % (34%, а НЕ 34 %)

calc.exe [Windows98/Win98/WinXP?] - временна памет за съхраняване на междинни резултати (достъпна чрез MC (memory clear?), MR (memory read?), MS (memory save?), M+ (?)
paint.exe (Windows98/WindowsXP SP3) vs. paint.exe (Windows7) vs. paint.exe (Windows10)
В режим Scientific (Научен режим) са достъпни някои специални математически функции, факториел (n!), работа с 10-ична (DEC), 2-ична (BIN), 8-ична (OCT) и 16-ична (HEX, HEXADEC, hexadecimal) БС (бройна система), и др.
~to add to BGlocalize, https://sites.google.com/site/bglocalize
„Цифрите, знаците и операциите се набират от клавиатурата или с „натискане“ на съответните бутони с показалеца (курсора), управляван от мишката.“ - стр. 105

file не е ФИЛЕ!!! :P
conversion & word-composition
======
'black comedy'/'horror comedy'/horrors = NO. I HATE THOSE. I _LOVE_ SEX&PROCREATION.
======
таблично представяне
2D изображение
3D изображение (статично или интерактивно/динамично)
---
кодирани (шифровани) съобщения
тайни шифри (шифър)

---
обзема, обхвана, 
-че
странник в странна земя
---
InfoWars, Veteran of the Psychic Wars, SpecOps, ShadowGovernment
---
и т.н. ИЛИ и т. н.
и др. (и други/друго/друга/друг)
пр.н.е. (пр.Хр.) ИЛИ пр. н. е. (пр. Хр.)
сл.н.е. (сл.Хр.) ИЛИ сл. н. е. (сл. Хр.)
1960-те, '60-те, `60-те, ,60-те (?!?)
условността и консенсусността на всички човешки знаци, символи и т.н.
Вселената говори с числа и синхроничности и с универсални и субективно-персонализирани знаци
---
bgjargon.com
---
еже- = ежедневно, ежеседмично, ежегодно
маршрута Банско--/-/---/em-dash/en-dashСептември
1 юли 1991 (г.) -/--/--- 12 септември 2019 г.
1991--2034
. или {без - пред/отстрани на скоба}
„ , “ („,“) = десетична запетая (при представяне на числа с десетична дробна част се използват допълнително десетична запетая за отделяне на цялата от дробната част, а при представяне на отрицателните числа - знакът „ - “ (минус). Понякога пред положителните числа се поставя знакът „ + “ (плюс).
-
{... ,} {А/}ако ..., то ...(.)
nested/nesting brackets = ((())) (с увеличаваща се от центъра навън големина = с големина, увеличаваща се от центъра навън) = вложени (цикли) скоби (?!?) - вложенност (дълбочина, нива) на скобите
от горе на долу ИЛИ отгоре надолу ИЛИ от горе надолу ИЛИ отгоре на долу (?!?)
от ляво на дясно ИЛИ от ляво надясно ИЛИ отляво на дясно ИЛИ отляво надясно (?!?)
при условие че ИЛИ при условие, че
в случай че ИЛИ в случай, че (съставни)
хиляда деветстотин деветдесет и девет(а(та)/о(то)/и(я(т))/и(те))
---
телефон с фонокарта = уличен телефон, улична телефонна кабина
---
